room name,desk group name,desk name
A,AA,AA001
A,AA,AA002
A,AA,AA003
A,AB,AB001
A,AB,AB002
A,AB,AB003
B,BA,BA001
B,BA,BA002
B,BA,BA003
B,BB,BB001
B,BB,BB002
B,BB,BB003
